 #####
##   #
#  # ###
# # *  #
# #  #@#
#   *  #
### *$##
  # . #
  #####
