#####
#   ####
#  $$  #
##.@ . #
 #. #.##
 # $$ #
 #  ###
 ####
