  ########
  #   #  #
  # . $. #
 ###$##  #
 #.. ##$##
## $*$   #
#  * #   #
#  @.#####
##   #
 #####
