#####
#. .#####
#  .    #
##$$@$  #
## ######
#  $ ##
#   . #
###   #
  #####
