##########
#. . . . #
#$ $ $ $ #
# # . # .#
# # $ # $#
# #   #  #
#   @    #
#        #
#        #
##########