     ####
######  #
#@ $. $ #
# $ .$  #
### . ###
  # . #
  #####
