########
#   #  #
#      #
## #.$.#
#  $@###
# #$*.#
# # # #
#     #
##   ##
 #####
