   ####
 ###  ##
##     ##
# ****+ #
#    $  #
##### # #
    #   #
    #####
