#######
#     #
# P B #
#   G #
#######