  ####
 ##  #
 # . #
## * #####
# @*$    #
#  * #   #
###  #####
  ####
