  ####
  #  #
  #  #
### *###
#      #
# .*** #
## $  ##
 ##* ##
  #@  #
  # # #
  #   #
  #####
