 ####
 #  ####
 #     #
## #.  #
# * #*##
# $  * #
# # @  #
#   ####
#####
