  ####
###  #
# *  ###
# .#   #
## $   #
#  #* ##
# @  ##
#  ###
####
