      #####
     ##   #
     #    #
    ##.#@##
   ## .#  #
  ##. .   #
 ##  $ #  #
##  $ #####
#  $ ##
# $ ##
#  ##
####
