  #####
###@  #
# $*#$##
# #  . #
# . $# #
## #.  #
 #    ##
 ###  #
   ####
