  #####
###   #
#GPB  #
### BG#
#G##B #
# # G ##
#B XBBG# 
#   G  #
########