 #######
## .   #
# $+$  #
# #*# ##
#  $  #
## . ##
 #   #
 #####
