 #####
##  .#
# $#.##
#     #
##$   #
#  #*##
# @  #
#  ###
####
