  #####
###   #
#   #.##
#  *$@ #
## * **##
 # # #  #
 #      #
 ###  ###
   ####
