 #######
 #  #  #
 #$.@.$#
 # .#. #
##$.#.$##
# $   $ #
#   #   #
#########
