 #########
 #   ##  #
 #       #
### ###  #
# $ @ # ##
#..* .#$#
# $.$ # ##
### ###  #
 #       #
 #   #  ##
 ########
