  #####
  #   ###
### # $ #
# $* .# #
# # +   #
#  *#.###
## $  #
 #  ###
 ####
