#####
#   #
# #*####
#    $ #
# # * @#
#.*  ###
## # #
 #   #
 #####
