  ####
 ##  #
 #   ####
##$ ..*.#
# $  #$ #
#    #@ #
#########
