 ####
 #  ###
 #    #
 # ** #
 # * ##
##$@ #
#  .*#
#  # #
##   #
 #####
